000000000000000000000000000000000000000000000
0 . . . . . . . . . . 0 . . . . . . . . . . 0
0 µ 00000 . 0000000 . 0 . 0000000 . 00000 µ 0
0 . 00000 . 0000000 . 0 . 0000000 . 00000 . 0
0 . . . . . . . . . . . . . . . . . . . . . 0
0 . 00000 . 0 . 0000000000000 . 0 . 00000 . 0
0 . . . . . 0 . 0000000000000 . 0 . . . . . 0
000000000 . 0 . . . . 0 . . . . 0 . 000000000
000000000 . 0000000   0   0000000 . 000000000
000000000 . 0                   0 . 000000000 
000000000 . 0   00000   00000   0 . 000000000 
          .     0 F F   F F 0     .
000000000 . 0   0000000000000   0 . 000000000 
000000000 . 0                   0 . 000000000 
000000000 . 0   0000000000000   0 . 000000000
000000000 . 0   0000000000000   0 . 000000000
0 . . . . . . . . . . 0 . . . . . . . . . . 0
0 . 00000 . 0000000 . 0 . 0000000 . 00000 . 0
0 µ . . 0 . . . . . . C . . . . . . 0 . . µ 0
00000 . 0 . 000000000000000000000 . 0 . 00000
0 . . . . . 0 . . . . 0 . . . . 0 . . . . . 0
0 . 000000000000000 . 0 . 000000000000000 . 0
0 . 000000000000000 . 0 . 000000000000000 . 0
0 . . . . . . . . . . . . . . . . . . . . . 0
000000000000000000000000000000000000000000000