000000000000000000000000000000000000000000000
012121212121212121212101212121212121212121210
013100000121000000012101210000000121000001310
012100000121000000012101210000000121000001210
012121212121212121212121212121212121212121210
012100000121012100000000000001210121000001210
012121212121012100000000000001210121212121210
000000000121012121212101212121210121000000000
000000000121000000011101110000000121000000000
000000000121011111111111111111110121000000000
000000000121011100000111000001110121000000000
111111111121111101414111414101111121111111111
000000000121011100000000000001110121000000000
000000000121011111111111111111110121000000000
000000000121011100000000000001110121000000000
000000000121011100000000000001110121000000000
012121212121212121212101212121212121212121210
012100000121000000012101210000000121000001210
013121210121212121212151212121212121012121310
000001210121000000000000000000000121012100000
012121212121012121212101212121210121212121210
012100000000000000012101210000000000000001210
012100000000000000012101210000000000000001210
012121212121212121212121212121212121212121210
000000000000000000000000000000000000000000000